root@ip-172-31-19-233:~/.nvm# php -v
PHP 5.6.23-1+deprecated+dontuse+deb.sury.org~trusty+1 (cli)
Copyright (c) 1997-2016 The PHP Group
Zend Engine v2.6.0, Copyright (c) 1998-2016 Zend Technologies
    with Zend OPcache v7.0.6-dev, Copyright (c) 1999-2016, by Zend Technologies
root@ip-172-31-19-233:~/.nvm# mysql -u root -pp
ERROR 1045 (28000): Access denied for user 'root'@'localhost' (using password: YES)
root@ip-172-31-19-233:~/.nvm# mysql -u root -p
Enter password:
Welcome to the MySQL monitor.  Commands end with ; or \g.
Your MySQL connection id is 106
Server version: 5.5.50-0ubuntu0.14.04.1 (Ubuntu)

Copyright (c) 2000, 2016, Oracle and/or its affiliates. All rights reserved.

Oracle is a registered trademark of Oracle Corporation and/or its
affiliates. Other names may be trademarks of their respective
owners.

Type 'help;' or '\h' for help. Type '\c' to clear the current input statement.

mysql> show databases;
+--------------------+
| Database           |
+--------------------+
| information_schema |
| mysql              |
| performance_schema |
| test               |
+--------------------+
4 rows in set (0.00 sec)

mysql> shwo databases;
ERROR 1064 (42000): You have an error in your SQL syntax; check the manual that corresponds to your MySQL server version for the right syntax to use near 'shwo databases' at line 1
mysql> shwo databases;
ERROR 1064 (42000): You have an error in your SQL syntax; check the manual that corresponds to your MySQL server version for the right syntax to use near 'shwo databases' at line 1
mysql> show databases;
+--------------------+
| Database           |
+--------------------+
| information_schema |
| mysql              |
| performance_schema |
| test               |
| test_db            |
+--------------------+
5 rows in set (0.00 sec)

mysql> show databases^CCtrl-C -- exit!
Aborted
root@ip-172-31-19-233:~/.nvm# cd /etc/nginx/nginx.conf
bash: cd: /etc/nginx/nginx.conf: Not a directory
root@ip-172-31-19-233:~/.nvm# ls -l
total 128
drwxrwxr-x 2 ubuntu ubuntu  4096 Jul  7 16:52 alias
-rw-rw-r-- 1 ubuntu ubuntu  1838 Jul  7 16:49 bash_completion
drwxrwxr-x 5 ubuntu ubuntu  4096 Aug  2 10:28 bin
-rw-rw-r-- 1 ubuntu ubuntu   763 Jul  7 16:49 CONTRIBUTING.md
-rwxrwxr-x 1 ubuntu ubuntu  7149 Jul  7 16:49 install.sh
-rw-rw-r-- 1 ubuntu ubuntu  1084 Jul  7 16:49 LICENSE.md
-rw-rw-r-- 1 ubuntu ubuntu  5212 Jul  7 16:49 Makefile
-rwxrwxr-x 1 ubuntu ubuntu   304 Jul  7 16:49 nvm-exec
-rwxrwxr-x 1 ubuntu ubuntu 51685 Jul  7 16:49 nvm.sh
-rw-rw-r-- 1 ubuntu ubuntu  1461 Jul  7 16:49 package.json
-rw-rw-r-- 1 ubuntu ubuntu  8210 Jul  7 16:49 README.markdown
drwxr-xr-x 3 root   root    4096 Aug  2 10:36 src
drwxrwxr-x 7 ubuntu ubuntu  4096 Jul  7 16:49 test
drwxr-xr-x 6 root   root    4096 Aug  2 10:27 v0.11.16
drwxr-xr-x 6 root   root    4096 Aug  2 10:41 v0.8.4
drwxrwxr-x 3 ubuntu ubuntu  4096 Jul  7 16:50 versions
root@ip-172-31-19-233:~/.nvm# pwd
/home/ubuntu/.nvm
root@ip-172-31-19-233:~/.nvm# cd /etc/nginx
root@ip-172-31-19-233:/etc/nginx# ls -l
total 64
drwxr-xr-x 2 root root 4096 Jun  2 15:16 conf.d
-rw-r--r-- 1 root root  911 Mar  4  2014 fastcgi_params
-rw-r--r-- 1 root root 2258 Mar  4  2014 koi-utf
-rw-r--r-- 1 root root 1805 Mar  4  2014 koi-win
-rw-r--r-- 1 root root 2085 Mar  4  2014 mime.types
-rw-r--r-- 1 root root 5287 Mar  4  2014 naxsi_core.rules
-rw-r--r-- 1 root root  287 Mar  4  2014 naxsi.rules
-rw-r--r-- 1 root root  222 Mar  4  2014 naxsi-ui.conf.1.4.1
-rw-r--r-- 1 root root 1601 Mar  4  2014 nginx.conf
-rw-r--r-- 1 root root  180 Mar  4  2014 proxy_params

▽
# You may add here your
# server {
#       ...
# }
# statements for each of your virtual hosts to this file

##
# You should look at the following URL's in order to grasp a solid understanding
# of Nginx configuration files in order to fully unleash the power of Nginx.
# http://wiki.nginx.org/Pitfalls
# http://wiki.nginx.org/QuickStart
# http://wiki.nginx.org/Configuration
#
# Generally, you will want to move this file somewhere, and start with a clean
# file but keep this around for reference. Or just disable in sites-enabled.
#
# Please see /usr/share/doc/nginx-doc/examples/ for more detailed examples.
##

server {
        listen 80 default_server;
        listen [::]:80 default_server ipv6only=on;

        root /usr/share/nginx/html;
        index index.html index.htm;

        # Make site accessible from http://localhost/
        server_name localhost;

        location / {
                # First attempt to serve request as file, then
                # as directory, then fall back to displaying a 404.
                try_files $uri $uri/ =404;
                # Uncomment to enable naxsi on this location
                # include /etc/nginx/naxsi.rules
        }

        # Only for nginx-naxsi used with nginx-naxsi-ui : process denied requests
"default" 112L, 2593C                                                                                                   1,1           Top